1111111111111111
1* 2  3   2    1
1     3   2    1
1222  3        1
1     3   2    1
1 22223   2    1
1     3   2  221
1         2    1
1222222222222  1
1       2      1
1    3     3   1
1  3333333333331
1              1
1  4 4 4 4 4 4 1
1              1
1111111111111111
