3333333333333333
3*             3
3 3   3        3
3   3          3
3 3   3        3
3              3
3              3
3              3
3              3
3              3
3              3
3              3
3              3
3              3
3              3
3333333333333333
